099|003|003|003|003|003|003|003|003|003|003|003|003|003|003|003
003|001|001|001|001|001|001|001|001|001|001|001|001|001|001|003
003|001|001|001|001|001|001|001|001|001|001|001|001|001|001|003
003|001|001|001|001|001|001|001|001|001|001|001|001|001|001|003
003|001|001|001|001|001|001|001|001|001|001|001|001|001|001|003
003|001|001|001|001|001|001|001|001|001|001|001|001|001|001|003
003|001|001|001|001|001|001|001|001|001|001|001|001|001|001|003
003|001|001|001|001|001|001|001|001|001|001|001|001|001|001|003
003|001|001|001|001|001|001|001|001|001|001|001|001|001|001|003
003|001|001|001|001|001|001|001|001|001|001|001|001|001|001|003
003|001|001|001|001|001|001|001|001|001|001|001|001|001|001|003
003|001|001|001|001|001|001|001|001|001|001|001|001|001|001|003
003|001|001|001|001|001|001|001|001|001|001|001|001|001|001|003
003|001|001|001|001|001|001|001|001|001|001|001|001|001|001|003
003|001|001|001|001|001|001|001|001|001|001|001|001|001|001|003
003|003|003|003|003|003|003|003|003|003|003|003|003|003|003|999